Quincy Acy,PF,28,PHO,10,123,4,18,.222,2,15,.133,2,3,.667,7,10,.700,17
Jaylen Adams,PG,22,ATL,34,428,38,110,.345,25,74,.338,13,36,.361,7,9,.778,108
Steven Adams,C,25,OKC,80,2669,481,809,.595,0,2,.000,481,807,.596,146,292,.500,1108
Bam Adebayo,C,21,MIA,82,1913,280,486,.576,3,15,.200,277,471,.588,166,226,.735,729
Deng Adel,SF,21,CLE,19,194,11,36,.306,6,23,.261,5,13,.385,4,4,1,32
DeVaughn Akoon-Purcell,SG,25,DEN,7,22,3,10,.300,0,4,.000,3,6,.500,1,2,.500,7
LaMarcus Aldridge,C,33,SAS,81,2687,684,1319,.519,10,42,.238,674,1277,.528,349,412,.847,1727
Rawle Alkins,SG,21,CHI,10,120,13,39,.333,3,12,.250,10,27,.370,8,12,.667,37
Grayson Allen,SG,23,UTA,38,416,67,178,.376,32,99,.323,35,79,.443,45,60,.750,211
Jarrett Allen,C,20,BRK,80,2096,335,568,.590,6,45,.133,329,523,.629,197,278,.709,873
Kadeem Allen,SG,26,NYK,19,416,65,141,.461,17,36,.472,48,105,.457,42,54,.778,189
Al-Farouq Aminu,PF,28,POR,81,2292,257,593,.433,96,280,.343,161,313,.514,150,173,.867,760
Justin Anderson,SF,25,ATL,48,463,64,157,.408,24,77,.312,40,80,.500,26,35,.743,178
Kyle Anderson,SF,25,MEM,43,1281,150,276,.543,9,34,.265,141,242,.583,37,64,.578,346
Ryan Anderson,PF,30,TOT,25,322,21,69,.304,9,40,.225,12,29,.414,12,16,.750,63
Giannis Antetokounmpo,PF,24,MIL,72,2358,721,1247,.578,52,203,.256,669,1044,.641,500,686,.729,1994
Carmelo Anthony,PF,34,HOU,10,294,49,121,.405,21,64,.328,28,57,.491,15,22,.682,134
OG Anunoby,SF,21,TOR,67,1352,183,404,.453,67,202,.332,116,202,.574,36,62,.581,469
Ryan Arcidiacono,PG,24,CHI,81,1961,187,418,.447,81,217,.373,106,201,.527,89,102,.873,544
Trevor Ariza,SF,33,TOT,69,2349,294,736,.399,145,434,.334,149,302,.493,130,164,.793,863
D.J. Augustin,PG,31,ORL,81,2269,318,677,.470,131,311,.421,187,366,.511,181,209,.866,948
Deandre Ayton,C,20,PHO,71,2183,509,870,.585,0,4,.000,509,866,.588,141,189,.746,1159
Dwayne Bacon,SG,23,CHO,43,759,122,257,.475,38,87,.437,84,170,.494,34,46,.739,316
Marvin Bagley III,PF,19,SAC,62,1567,356,706,.504,30,96,.313,326,610,.534,181,262,.691,923
Ron Baker,SG,25,TOT,15,152,4,20,.200,1,13,.077,3,7,.429,5,6,.833,14
Wade Baldwin,PG,22,POR,16,94,10,33,.303,2,9,.222,8,24,.333,8,11,.727,30
Lonzo Ball,PG,21,LAL,47,1423,185,456,.406,75,228,.329,110,228,.482,20,48,.417,465
Mo Bamba,C,20,ORL,47,766,117,243,.481,21,70,.300,96,173,.555,37,63,.587,292
J.J. Barea,PG,34,DAL,38,752,161,385,.418,38,128,.297,123,257,.479,55,78,.705,415
Harrison Barnes,PF-SF,26,TOT,77,2533,431,1027,.420,174,441,.395,257,586,.439,229,278,.824,1265
Will Barton,SF,28,DEN,43,1189,185,460,.402,67,196,.342,118,264,.447,57,74,.770,494
Keita Bates-Diop,SF,23,MIN,30,503,60,142,.423,13,52,.250,47,90,.522,18,28,.643,151
Nicolas Batum,SF,30,CHO,75,2354,253,562,.450,116,298,.389,137,264,.519,77,89,.865,699
Jerryd Bayless,PG,30,MIN,34,657,82,230,.357,29,98,.296,53,132,.402,16,28,.571,209
Aron Baynes,C,32,BOS,51,821,105,223,.471,21,61,.344,84,162,.519,53,62,.855,284
Kent Bazemore,SG,29,ATL,67,1643,278,691,.402,96,300,.320,182,391,.465,127,175,.726,779
Bradley Beal,SG,25,WAS,82,3028,764,1609,.475,209,596,.351,555,1013,.548,362,448,.808,2099
Malik Beasley,SG,22,DEN,81,1879,349,737,.474,163,405,.402,186,332,.560,56,66,.848,917
Michael Beasley,PF,30,LAL,26,277,75,153,.490,3,17,.176,72,136,.529,28,39,.718,181
Marco Belinelli,SG,32,SAS,79,1815,285,690,.413,147,395,.372,138,295,.468,112,124,.903,829
Jordan Bell,C,24,GSW,68,788,99,192,.516,0,2,.000,99,190,.521,25,41,.610,223
Dragan Bender,PF,21,PHO,46,826,88,197,.447,22,101,.218,66,96,.688,32,54,.593,230
Patrick Beverley,PG,30,LAC,78,2137,194,477,.407,112,282,.397,82,195,.421,96,123,.780,596
Khem Birch,C,26,ORL,50,643,91,151,.603,0,1,.000,91,150,.607,58,83,.699,240
Nemanja Bjelica,PF,30,SAC,77,1788,284,593,.479,103,257,.401,181,336,.539,70,92,.761,741
Antonio Blakeney,SG,22,CHI,57,829,166,396,.419,36,91,.396,130,305,.426,50,76,.658,418
Eric Bledsoe,PG,29,MIL,78,2272,470,971,.484,124,377,.329,346,594,.582,177,236,.750,1241
Jaron Blossomgame,SF,25,CLE,27,439,47,106,.443,10,39,.256,37,67,.552,10,13,.769,114
Jonah Bolden,PF,23,PHI,44,639,80,162,.494,34,96,.354,46,66,.697,13,27,.481,207
Isaac Bonga,PG,19,LAL,22,120,5,33,.152,0,8,.000,5,25,.200,9,15,.600,19
Devin Booker,SG,22,PHO,64,2242,586,1255,.467,135,414,.326,451,841,.536,393,454,.866,1700
Chris Boucher,PF,26,TOR,28,163,34,76,.447,12,37,.324,22,39,.564,13,15,.867,93
Avery Bradley,SG,28,TOT,63,1905,248,608,.408,86,245,.351,162,363,.446,43,50,.860,625
Corey Brewer,SF,32,TOT,31,492,53,123,.431,14,44,.318,39,79,.494,31,43,.721,151
Mikal Bridges,SF,22,PHO,82,2417,242,563,.430,105,313,.335,137,250,.548,95,118,.805,684
Miles Bridges,SF,20,CHO,80,1696,237,511,.464,65,200,.325,172,311,.553,58,77,.753,597
Isaiah Briscoe,PG,22,ORL,39,559,55,138,.399,11,34,.324,44,104,.423,15,26,.577,136
Ryan Broekhoff,SG,28,DAL,42,453,57,126,.452,38,93,.409,19,33,.576,15,19,.789,167
Malcolm Brogdon,SG,26,MIL,64,1832,378,748,.505,104,244,.426,274,504,.544,141,152,.928,1001
Dillon Brooks,SF,23,MEM,18,330,49,122,.402,15,40,.375,34,82,.415,22,30,.733,135
MarShon Brooks,SG,30,MEM,29,387,76,169,.450,15,54,.278,61,115,.530,23,33,.697,190
Bruce Brown,SG,22,DET,74,1449,125,314,.398,24,93,.258,101,221,.457,45,60,.750,319
Jaylen Brown,SG,22,BOS,74,1913,368,792,.465,95,276,.344,273,516,.529,133,202,.658,964
Lorenzo Brown,PG,28,TOR,26,212,23,71,.324,6,28,.214,17,43,.395,3,3,1,55
Sterling Brown,SG,23,MIL,58,1034,145,312,.465,53,147,.361,92,165,.558,29,42,.690,372
Troy Brown Jr.,SF,19,WAS,52,730,97,234,.415,22,69,.319,75,165,.455,32,47,.681,248
Jalen Brunson,PG,22,DAL,73,1591,264,565,.467,63,181,.348,201,384,.523,87,120,.725,678
Thomas Bryant,C,21,WAS,72,1496,309,502,.616,33,99,.333,276,403,.685,107,137,.781,758
Reggie Bullock,SG,27,TOT,63,1879,245,594,.412,148,393,.377,97,201,.483,73,85,.859,711
Trey Burke,PG,26,TOT,58,1125,236,548,.431,56,159,.352,180,389,.463,103,124,.831,631
Alec Burks,SG,27,TOT,64,1375,192,474,.405,61,168,.363,131,306,.428,116,141,.823,561
Deonte Burton,SG,25,OKC,32,240,33,82,.402,8,27,.296,25,55,.455,8,12,.667,82
Jimmy Butler,SF-SG,29,TOT,65,2185,418,904,.462,67,193,.347,351,711,.494,312,365,.855,1215
Bruno Caboclo,SF,23,MEM,34,800,96,225,.427,48,130,.369,48,95,.505,42,50,.840,282
Isaiah Canaan,PG,27,TOT,30,629,64,164,.390,34,96,.354,30,68,.441,19,24,.792,181
DeMarre Carroll,PF,32,BRK,67,1703,227,575,.395,106,310,.342,121,265,.457,184,242,.760,744
Jevon Carter,PG,23,MEM,39,577,56,185,.303,34,102,.333,22,83,.265,26,32,.813,172
Vince Carter,PF,42,ATL,76,1330,196,468,.419,123,316,.389,73,152,.480,47,66,.712,562
Wendell Carter Jr.,C,19,CHI,44,1110,180,371,.485,6,32,.188,174,339,.513,89,112,.795,455
Michael Carter-Williams,PG,27,TOT,28,372,46,123,.374,10,38,.263,36,85,.424,32,53,.604,134
Alex Caruso,PG,24,LAL,25,531,77,173,.445,24,50,.480,53,123,.431,51,64,.797,229
Omri Casspi,SF,30,MEM,36,520,86,161,.534,15,43,.349,71,118,.602,39,58,.672,226
Willie Cauley-Stein,C,25,SAC,81,2213,412,741,.556,1,2,.500,411,739,.556,140,254,.551,965
Tyler Cavanaugh,PF,24,UTA,11,39,3,10,.300,1,5,.200,2,5,.400,2,2,1,9
Tyson Chandler,C,36,TOT,55,875,61,99,.616,0,1,.000,61,98,.622,51,87,.586,173
Wilson Chandler,PF-SF,31,TOT,51,1177,114,273,.418,59,158,.373,55,115,.478,18,25,.720,305
Marquese Chriss,PF,21,TOT,43,499,67,180,.372,16,72,.222,51,108,.472,32,45,.711,182
Gary Clark,PF,24,HOU,51,641,50,151,.331,41,138,.297,9,13,.692,7,7,1,148
Ian Clark,SG,27,NOP,60,973,151,383,.394,66,202,.327,85,181,.470,33,37,.892,401
Jordan Clarkson,SG,26,CLE,81,2214,529,1180,.448,144,445,.324,385,735,.524,162,192,.844,1364
John Collins,PF,21,ATL,61,1829,465,831,.560,55,158,.348,410,673,.609,203,266,.763,1188
Zach Collins,C,21,POR,77,1356,189,400,.473,40,121,.331,149,279,.534,94,126,.746,512
Darren Collison,PG,31,IND,76,2143,308,659,.467,79,194,.407,229,465,.492,158,190,.832,853
Bonzie Colson,SF,23,MIL,8,98,13,39,.333,5,21,.238,8,18,.444,8,9,.889,39
Mike Conley,PG,31,MEM,70,2342,490,1120,.438,155,426,.364,335,694,.483,343,406,.845,1478
Pat Connaughton,SG,26,MIL,61,1261,163,350,.466,66,200,.330,97,150,.647,29,40,.725,421
Quinn Cook,PG,25,GSW,74,1059,204,439,.465,81,200,.405,123,239,.515,20,26,.769,509
DeMarcus Cousins,C,28,GSW,30,771,178,371,.480,26,95,.274,152,276,.551,106,144,.736,488
Robert Covington,SF,28,TOT,35,1203,156,362,.431,85,225,.378,71,137,.518,68,89,.764,465
Allen Crabbe,SG,26,BRK,43,1133,137,373,.367,98,259,.378,39,114,.342,41,56,.732,413
Torrey Craig,SF,28,DEN,75,1503,160,362,.442,61,188,.324,99,174,.569,49,70,.700,430
Jamal Crawford,SG,38,PHO,64,1211,174,438,.397,67,202,.332,107,236,.453,93,110,.845,508
Mitch Creek,SF,26,TOT,5,48,8,16,.500,0,2,.000,8,14,.571,5,7,.714,21
Jae Crowder,SF,28,UTA,80,2166,318,797,.399,173,522,.331,145,275,.527,142,197,.721,951
Dante Cunningham,PF,31,SAS,64,928,75,158,.475,30,65,.462,45,93,.484,14,18,.778,194
Seth Curry,SG,28,POR,74,1399,212,465,.456,113,251,.450,99,214,.463,44,52,.846,581
Stephen Curry,PG,30,GSW,69,2331,632,1340,.472,354,810,.437,278,530,.525,263,287,.916,1881
Troy Daniels,SG,27,PHO,51,760,113,275,.411,74,194,.381,39,81,.481,18,23,.783,318
Anthony Davis,C,25,NOP,56,1850,530,1026,.517,48,145,.331,482,881,.547,344,433,.794,1452
Deyonta Davis,C,22,ATL,9,118,15,22,.682,0,1,.000,15,21,.714,6,10,.600,36
Ed Davis,C,29,BRK,81,1446,186,302,.616,0,2,.000,186,300,.620,100,162,.617,472
Dewayne Dedmon,C,29,ATL,64,1609,259,526,.492,83,217,.382,176,309,.570,92,113,.814,693
Sam Dekker,PF,24,TOT,47,788,120,256,.469,19,62,.306,101,194,.521,28,46,.609,287
Matthew Dellavedova,PG,28,TOT,48,812,98,242,.405,44,130,.338,54,112,.482,42,52,.808,282
Luol Deng,SF,33,MIN,22,392,59,118,.500,14,44,.318,45,74,.608,25,35,.714,157
DeMar DeRozan,SG,29,SAS,77,2688,631,1313,.481,7,45,.156,624,1268,.492,366,441,.830,1635
Marcus Derrickson,PF,22,GSW,11,67,16,33,.485,10,20,.500,6,13,.462,4,5,.800,46
Cheick Diallo,PF,22,NOP,64,896,168,271,.620,1,4,.250,167,267,.625,50,67,.746,387
Hamidou Diallo,SG,20,OKC,51,526,75,165,.455,4,24,.167,71,141,.504,36,59,.610,190
Gorgui Dieng,C,29,MIN,76,1031,189,377,.501,19,56,.339,170,321,.530,88,106,.830,485
Spencer Dinwiddie,PG,25,BRK,68,1914,366,828,.442,124,370,.335,242,458,.528,287,356,.806,1143
Donte DiVincenzo,SG,22,MIL,27,411,50,124,.403,22,83,.265,28,41,.683,9,12,.750,131
Tyler Dorsey,SG,22,TOT,48,698,107,264,.405,44,132,.333,63,132,.477,38,61,.623,296
Damyean Dotson,SG,24,NYK,73,2004,290,698,.415,126,342,.368,164,356,.461,73,98,.745,779
PJ Dozier,SG,22,BOS,6,51,8,21,.381,2,8,.250,6,13,.462,1,2,.500,19
Andre Drummond,C,25,DET,79,2647,561,1052,.533,5,38,.132,556,1014,.548,243,412,.590,1370
Jared Dudley,PF,33,BRK,59,1220,101,239,.423,53,151,.351,48,88,.545,32,46,.696,287
Kris Dunn,PG,24,CHI,46,1389,215,506,.425,34,96,.354,181,410,.441,55,69,.797,519
Kevin Durant,SF,30,GSW,78,2702,721,1383,.521,137,388,.353,584,995,.587,448,506,.885,2027
Henry Ellenson,PF,22,TOT,19,259,39,95,.411,17,38,.447,22,57,.386,19,25,.760,114
Wayne Ellington,SG,31,TOT,53,1297,184,457,.403,138,372,.371,46,85,.541,39,49,.796,545
Joel Embiid,C,24,PHI,64,2154,580,1199,.484,79,263,.300,501,936,.535,522,649,.804,1761
James Ennis,SF,28,TOT,58,1230,138,294,.469,55,156,.353,83,138,.601,58,81,.716,389
Jacob Evans,SG,21,GSW,30,204,18,53,.340,4,15,.267,14,38,.368,0,1,.000,40
Tyreke Evans,SG,29,IND,69,1402,257,660,.389,77,216,.356,180,444,.405,115,160,.719,706
Dante Exum,PG,23,UTA,42,664,101,241,.419,18,62,.290,83,179,.464,68,86,.791,288
Kenneth Faried,C,29,TOT,37,728,156,265,.589,8,25,.320,148,240,.617,64,99,.646,384
Derrick Favors,C,27,UTA,76,1766,363,619,.586,17,78,.218,346,541,.640,154,228,.675,897
Raymond Felton,PG,34,OKC,33,379,55,135,.407,20,61,.328,35,74,.473,12,13,.923,142
Cristiano Felício,C,26,CHI,60,746,95,179,.531,0,4,.000,95,175,.543,50,73,.685,240
Terrance Ferguson,SG,20,OKC,74,1931,185,431,.429,106,290,.366,79,141,.560,37,51,.725,513
Yogi Ferrell,PG,25,SAC,71,1067,153,352,.435,54,149,.362,99,203,.488,60,67,.896,420
Dorian Finney-Smith,SF,25,DAL,81,1985,228,528,.432,79,254,.311,149,274,.544,73,103,.709,608
Bryn Forbes,SG,25,SAS,82,2293,361,791,.456,176,413,.426,185,378,.489,69,78,.885,967
Evan Fournier,SG,26,ORL,81,2553,468,1069,.438,153,450,.340,315,619,.509,137,170,.806,1226
Melvin Frazier,SG,22,ORL,10,44,7,21,.333,0,6,.000,7,15,.467,1,4,.250,15
Tim Frazier,PG,28,TOT,59,1120,116,261,.444,37,101,.366,79,160,.494,41,54,.759,310
Jimmer Fredette,SG,29,PHO,6,65,8,29,.276,0,13,.000,8,16,.500,6,6,1,22
Channing Frye,C,35,CLE,36,341,43,117,.368,32,79,.405,11,38,.289,11,14,.786,129
Markelle Fultz,SG,20,PHI,19,427,65,155,.419,4,14,.286,61,141,.433,21,37,.568,155
Danilo Gallinari,SF,30,LAC,68,2059,409,884,.463,161,372,.433,248,512,.484,367,406,.904,1346
Langston Galloway,SG,27,DET,80,1745,228,587,.388,135,380,.355,93,207,.449,81,96,.844,672
Billy Garrett,SG,24,NYK,4,63,11,27,.407,0,8,.000,11,19,.579,4,4,1,26
Marc Gasol,C,34,TOT,79,2436,390,870,.448,99,273,.363,291,597,.487,192,253,.759,1071
Pau Gasol,C,38,TOT,30,360,42,94,.447,6,13,.462,36,81,.444,28,40,.700,118
Rudy Gay,PF,32,SAS,69,1842,376,746,.504,74,184,.402,302,562,.537,120,147,.816,946
Paul George,SF,28,OKC,77,2841,707,1614,.438,292,757,.386,415,857,.484,453,540,.839,2159
Taj Gibson,PF,33,MIN,70,1686,304,537,.566,11,34,.324,293,503,.583,134,177,.757,753
Harry Giles,PF,20,SAC,58,820,175,348,.503,0,6,.000,175,342,.512,58,91,.637,408
Shai Gilgeous-Alexander,PG,20,LAC,82,2174,341,716,.476,51,139,.367,290,577,.503,156,195,.800,889
Brandon Goodwin,PG,23,DEN,16,57,6,23,.261,2,6,.333,4,17,.235,9,11,.818,23
Aaron Gordon,PF,23,ORL,78,2633,470,1046,.449,121,347,.349,349,699,.499,185,253,.731,1246
Eric Gordon,SG,30,HOU,68,2158,384,938,.409,216,600,.360,168,338,.497,119,152,.783,1103
Treveon Graham,SG,25,BRK,35,715,64,191,.335,38,128,.297,26,63,.413,18,22,.818,184
Jerami Grant,PF,24,OKC,80,2612,409,823,.497,115,293,.392,294,530,.555,157,221,.710,1090
Jerian Grant,PG,26,ORL,60,939,92,220,.418,40,110,.364,52,110,.473,26,40,.650,250
Danny Green,SG,31,TOR,80,2216,293,630,.465,198,435,.455,95,195,.487,37,44,.841,821
Draymond Green,PF,28,GSW,66,2065,188,422,.445,47,165,.285,141,257,.549,63,91,.692,486
Gerald Green,SG,33,HOU,73,1473,231,578,.400,156,441,.354,75,137,.547,57,68,.838,675
JaMychal Green,PF,28,TOT,65,1371,230,476,.483,71,176,.403,159,300,.530,80,101,.792,611
Jeff Green,PF,32,WAS,77,2097,326,687,.475,111,320,.347,215,367,.586,183,206,.888,946
Blake Griffin,PF,29,DET,75,2622,619,1341,.462,189,522,.362,430,819,.525,414,550,.753,1841
Daniel Hamilton,SG,23,ATL,19,204,23,60,.383,8,23,.348,15,37,.405,3,6,.500,57
Dusty Hannahs,SG,25,MEM,2,26,3,12,.250,0,5,.000,3,7,.429,2,2,1,8
Tim Hardaway Jr.,SG,26,TOT,65,2057,390,993,.393,162,477,.340,228,516,.442,232,276,.841,1174
James Harden,PG,29,HOU,78,2867,843,1909,.442,378,1028,.368,465,881,.528,754,858,.879,2818
Maurice Harkless,SF,25,POR,60,1415,189,388,.487,33,120,.275,156,268,.582,49,73,.671,460
Montrezl Harrell,C,25,LAC,82,2158,546,888,.615,3,17,.176,543,871,.623,266,414,.643,1361
Devin Harris,PG,35,DAL,68,1071,132,347,.380,62,200,.310,70,147,.476,102,134,.761,428
Gary Harris,SG,24,DEN,57,1639,270,637,.424,82,242,.339,188,395,.476,115,144,.799,737
Joe Harris,SG,27,BRK,76,2293,374,748,.500,183,386,.474,191,362,.528,110,133,.827,1041
Tobias Harris,PF,26,TOT,82,2847,611,1254,.487,156,393,.397,455,861,.528,266,307,.866,1644
Andrew Harrison,PG,24,TOT,17,187,16,53,.302,5,25,.200,11,28,.393,17,18,.944,54
Shaquille Harrison,SG,25,CHI,73,1430,184,426,.432,24,89,.270,160,337,.475,82,123,.667,474
Josh Hart,SG,23,LAL,67,1715,189,464,.407,92,274,.336,97,190,.511,55,80,.688,525
Isaiah Hartenstein,PF,20,HOU,28,221,20,41,.488,2,6,.333,18,35,.514,11,14,.786,53
Udonis Haslem,C,38,MIA,10,74,11,33,.333,0,12,.000,11,21,.524,3,4,.750,25
Gordon Hayward,PF,28,BOS,72,1863,296,635,.466,77,231,.333,219,404,.542,156,187,.834,825
John Henson,C,28,MIL,14,188,31,67,.463,11,31,.355,20,36,.556,6,10,.600,79
Mario Hezonja,SF,23,NYK,58,1206,191,464,.412,42,152,.276,149,312,.478,87,114,.763,511
Buddy Hield,SG,26,SAC,82,2615,623,1360,.458,278,651,.427,345,709,.487,171,193,.886,1695
Haywood Highsmith,SF,22,PHI,5,40,4,10,.400,1,5,.200,3,5,.600,0,2,.000,9
George Hill,PG,32,TOT,60,1302,170,376,.452,48,153,.314,122,223,.547,70,85,.824,458
Solomon Hill,SF,27,NOP,44,878,68,178,.382,32,101,.317,36,77,.468,23,32,.719,191
Nenê,C,36,HOU,42,546,60,116,.517,0,3,.000,60,113,.531,31,47,.660,151
Aaron Holiday,PG,22,IND,50,646,105,262,.401,43,127,.339,62,135,.459,41,50,.820,294
Jrue Holiday,SG,28,NOP,67,2402,547,1159,.472,118,363,.325,429,796,.539,208,271,.768,1420
Justin Holiday,SG,29,TOT,82,2607,300,777,.386,162,465,.348,138,312,.442,95,106,.896,857
Rondae Hollis-Jefferson,SF,24,BRK,59,1234,200,487,.411,9,49,.184,191,438,.436,118,183,.645,527
Rodney Hood,SG,26,TOT,72,1893,292,671,.435,84,236,.356,208,435,.478,137,155,.884,805
Al Horford,C,32,BOS,68,1973,387,723,.535,73,203,.360,314,520,.604,78,95,.821,925
Danuel House,SF,25,HOU,39,979,118,252,.468,74,178,.416,44,74,.595,56,71,.789,366
Kevin Huerter,SG,20,ATL,75,2048,275,657,.419,136,353,.385,139,304,.457,41,56,.732,727
R.J. Hunter,SG,25,BOS,1,26,6,13,.462,4,10,.400,2,3,.667,1,2,.500,17
Chandler Hutchison,SF,22,CHI,44,895,96,209,.459,14,50,.280,82,159,.516,23,38,.605,229
Serge Ibaka,C,29,TOR,74,2010,464,877,.529,49,169,.290,415,708,.586,135,177,.763,1112
Andre Iguodala,SF,35,GSW,68,1578,151,302,.500,48,144,.333,103,158,.652,39,67,.582,389
Joe Ingles,PF,31,UTA,82,2568,359,802,.448,189,483,.391,170,319,.533,87,123,.707,994
Brandon Ingram,SF,21,LAL,52,1760,362,729,.497,31,94,.330,331,635,.521,195,289,.675,950
Kyrie Irving,PG,26,BOS,67,2214,604,1241,.487,174,434,.401,430,807,.533,214,245,.873,1596
Jonathan Isaac,PF,21,ORL,75,1996,262,611,.429,86,266,.323,176,345,.510,110,135,.815,720
Wesley Iwundu,SF,24,ORL,68,1233,113,274,.412,29,79,.367,84,195,.431,84,103,.816,339
Demetrius Jackson,PG,24,PHI,6,39,8,15,.533,2,6,.333,6,9,.667,4,4,1,22
Frank Jackson,PG,20,NOP,61,1169,194,447,.434,53,169,.314,141,278,.507,54,73,.740,495
Jaren Jackson Jr.,PF,19,MEM,58,1515,298,589,.506,51,142,.359,247,447,.553,151,197,.766,798
Josh Jackson,SG,21,PHO,79,1988,347,841,.413,73,225,.324,274,616,.445,143,213,.671,910
Justin Jackson,SF,23,TOT,81,1614,217,485,.447,87,245,.355,130,240,.542,62,79,.785,583
Reggie Jackson,PG,28,DET,82,2289,441,1047,.421,174,471,.369,267,576,.464,204,236,.864,1260
LeBron James,SF,34,LAL,55,1937,558,1095,.510,111,327,.339,447,768,.582,278,418,.665,1505
John Jenkins,SG,27,TOT,26,333,42,105,.400,22,58,.379,20,47,.426,15,18,.833,121
Jonas Jerebko,PF,31,GSW,73,1218,163,355,.459,69,188,.367,94,167,.563,64,80,.800,459
Alize Johnson,PF,22,IND,14,64,4,16,.250,1,2,.500,3,14,.214,4,8,.500,13
Amir Johnson,C,31,PHI,51,529,79,157,.503,12,40,.300,67,117,.573,31,41,.756,201
B.J. Johnson,SF,23,TOT,7,49,9,18,.500,3,7,.429,6,11,.545,2,2,1,23
James Johnson,PF,31,MIA,55,1164,164,379,.433,50,149,.336,114,230,.496,50,70,.714,428
Stanley Johnson,SF,22,TOT,66,1208,171,440,.389,62,215,.288,109,225,.484,50,64,.781,454
Tyler Johnson,PG,26,TOT,57,1529,217,526,.413,90,260,.346,127,266,.477,95,127,.748,619
Wesley Johnson,SF,31,TOT,38,534,45,128,.352,25,76,.329,20,52,.385,13,19,.684,128
Derrick Jones Jr.,SF,21,MIA,60,1153,160,324,.494,28,91,.308,132,233,.567,74,122,.607,422
Jalen Jones,SF,25,CLE,16,214,26,62,.419,10,28,.357,16,34,.471,19,27,.704,81
Jemerrio Jones,SF,23,LAL,6,143,12,33,.364,2,10,.200,10,23,.435,1,2,.500,27
Terrence Jones,PF,27,HOU,2,5,1,4,.250,0,2,.000,1,2,.500,0,1,.000,2
Tyus Jones,PG,22,MIN,68,1560,185,446,.415,40,126,.317,145,320,.453,58,69,.841,468
Cory Joseph,PG,27,IND,82,2063,226,548,.412,55,171,.322,171,377,.454,30,43,.698,537
Frank Kaminsky,C,25,CHO,47,755,138,298,.463,50,139,.360,88,159,.553,79,107,.738,405
Enes Kanter,C,26,TOT,67,1640,375,683,.549,10,34,.294,365,649,.562,155,197,.787,915
Luke Kennard,SG,22,DET,63,1437,228,520,.438,106,269,.394,122,251,.486,51,61,.836,613
Michael Kidd-Gilchrist,PF,25,CHO,64,1179,158,332,.476,16,47,.340,142,285,.498,95,123,.772,427
Maxi Kleber,PF,27,DAL,71,1502,175,386,.453,77,218,.353,98,168,.583,58,74,.784,485
Brandon Knight,PG,27,TOT,39,736,99,260,.381,41,129,.318,58,131,.443,27,34,.794,266
Kevin Knox,PF,19,NYK,75,2158,338,914,.370,125,364,.343,213,550,.387,162,226,.717,963
Furkan Korkmaz,SG,21,PHI,48,679,98,245,.400,47,144,.326,51,101,.505,36,44,.818,279
Luke Kornet,PF,23,NYK,46,784,107,283,.378,70,193,.363,37,90,.411,38,46,.826,322
Kyle Korver,SG-PF,37,TOT,70,1334,201,483,.416,138,348,.397,63,135,.467,60,73,.822,600
Rodions Kurucs,SF,20,BRK,63,1294,202,449,.450,58,184,.315,144,265,.543,72,92,.783,534
Kyle Kuzma,PF,23,LAL,70,2314,496,1087,.456,128,422,.303,368,665,.553,188,250,.752,1308
Jeremy Lamb,SG,26,CHO,79,2250,431,979,.440,115,330,.348,316,649,.487,231,260,.888,1208
Zach LaVine,SG,23,CHI,63,2171,530,1135,.467,120,321,.374,410,814,.504,312,375,.832,1492
Jake Layman,SF,24,POR,71,1327,216,424,.509,59,181,.326,157,243,.646,50,71,.704,541
T.J. Leaf,PF,21,IND,58,522,99,183,.541,8,31,.258,91,152,.599,19,31,.613,225
Courtney Lee,SG,33,TOT,34,428,53,129,.411,16,55,.291,37,74,.500,14,21,.667,136
Damion Lee,SG,26,GSW,32,375,56,127,.441,27,68,.397,29,59,.492,19,22,.864,158
Walt Lemon Jr.,PG,26,CHI,6,167,38,87,.437,2,5,.400,36,82,.439,8,11,.727,86
Alex Len,C,25,ATL,77,1544,320,648,.494,74,204,.363,246,444,.554,140,216,.648,854
Kawhi Leonard,SF,27,TOR,60,2040,560,1129,.496,112,302,.371,448,827,.542,364,426,.854,1596
Meyers Leonard,C,26,POR,61,878,132,242,.545,50,111,.450,82,131,.626,43,51,.843,357
Jon Leuer,PF,29,DET,41,402,66,113,.584,1,11,.091,65,102,.637,23,31,.742,156
Caris LeVert,SF,24,BRK,40,1063,207,483,.429,48,154,.312,159,329,.483,85,123,.691,547
Damian Lillard,PG,28,POR,80,2838,681,1533,.444,237,643,.369,444,890,.499,468,513,.912,2067
Jeremy Lin,PG,30,TOT,74,1436,238,541,.440,55,187,.294,183,354,.517,176,210,.838,707
Shaun Livingston,PG,33,GSW,64,967,109,210,.519,0,2,.000,109,208,.524,40,51,.784,258
Kevon Looney,C,22,GSW,80,1481,217,347,.625,1,10,.100,216,337,.641,65,105,.619,500
Brook Lopez,C,30,MIL,81,2322,355,786,.452,187,512,.365,168,274,.613,112,133,.842,1009
Robin Lopez,C,30,CHI,74,1606,304,535,.568,7,31,.226,297,504,.589,89,123,.724,704
Kevin Love,PF,30,CLE,22,598,109,283,.385,53,147,.361,56,136,.412,103,114,.904,374
Kyle Lowry,PG,32,TOR,65,2213,304,739,.411,157,453,.347,147,286,.514,161,194,.830,926
Jordan Loyd,PG,25,TOR,12,55,8,18,.444,4,8,.500,4,10,.400,9,11,.818,29
Timothé Luwawu-Cabarrot,SF,23,TOT,50,669,82,218,.376,36,116,.310,46,102,.451,31,41,.756,231
Tyler Lydon,PF,22,DEN,25,94,9,18,.500,4,10,.400,5,8,.625,1,3,.333,23
Trey Lyles,PF,23,DEN,64,1120,207,495,.418,51,200,.255,156,295,.529,81,116,.698,546
Shelvin Mack,PG,28,TOT,57,1246,163,403,.404,46,130,.354,117,273,.429,58,84,.690,430
Daryl Macon,SG,23,DAL,8,90,10,27,.370,5,11,.455,5,16,.313,4,7,.571,29
Ian Mahinmi,C,32,WAS,34,498,47,104,.452,3,16,.188,44,88,.500,42,61,.689,139
Thon Maker,C-PF,21,TOT,64,972,109,268,.407,49,153,.320,60,115,.522,56,84,.667,323
Lauri Markkanen,PF,21,CHI,52,1682,342,795,.430,120,332,.361,222,463,.479,170,195,.872,974
Jarell Martin,PF,24,ORL,42,328,43,104,.413,20,57,.351,23,47,.489,9,11,.818,115
Frank Mason III,PG,24,SAC,38,435,71,169,.420,14,64,.219,57,105,.543,39,57,.684,195
Wesley Matthews,SF-SG,32,TOT,69,2091,279,698,.400,150,403,.372,129,295,.437,132,163,.810,840
Luc Mbah a Moute,PF,32,LAC,4,61,8,18,.444,2,6,.333,6,12,.500,2,5,.400,20
Tahjere McCall,SG,24,BRK,1,8,2,3,.667,0,1,.000,2,2,1,0,1,.000,4
Patrick McCaw,SG,23,TOT,29,397,26,63,.413,9,28,.321,17,35,.486,13,15,.867,74
CJ McCollum,SG,27,POR,70,2375,571,1243,.459,167,445,.375,404,798,.506,159,192,.828,1468
T.J. McConnell,PG,26,PHI,76,1470,220,419,.525,14,42,.333,206,377,.546,29,37,.784,483
Doug McDermott,SF,27,IND,77,1340,207,422,.491,84,206,.408,123,216,.569,66,79,.835,564
JaVale McGee,C,31,LAL,75,1671,400,641,.624,1,12,.083,399,629,.634,96,152,.632,897
Rodney McGruder,SG,27,MIA,66,1550,186,461,.403,79,225,.351,107,236,.453,52,72,.722,503
Alfonzo McKinnie,SF,26,GSW,72,1003,134,275,.487,42,118,.356,92,157,.586,27,48,.563,337
Ben McLemore,SG,25,SAC,19,158,25,64,.391,17,41,.415,8,23,.348,8,12,.667,75
Jordan McRae,SG,27,WAS,27,333,61,130,.469,10,35,.286,51,95,.537,28,35,.800,160
Salah Mejri,C,32,DAL,36,399,55,112,.491,11,34,.324,44,78,.564,20,32,.625,141
Chimezie Metu,PF,21,SAS,29,145,19,58,.328,0,2,.000,19,56,.339,13,17,.765,51
Khris Middleton,SF,27,MIL,77,2393,506,1148,.441,179,474,.378,327,674,.485,216,258,.837,1407
C.J. Miles,SF,31,TOT,53,856,112,311,.360,67,203,.330,45,108,.417,48,58,.828,339
Darius Miller,SF,28,NOP,69,1757,189,484,.390,133,364,.365,56,120,.467,56,71,.789,567
Malcolm Miller,SF,25,TOR,10,67,11,26,.423,10,21,.476,1,5,.200,3,4,.750,35
Patty Mills,PG,30,SAS,82,1908,282,663,.425,159,404,.394,123,259,.475,88,103,.854,811
Paul Millsap,PF,33,DEN,70,1895,322,665,.484,58,159,.365,264,506,.522,181,249,.727,883
Shake Milton,SG,22,PHI,20,268,34,87,.391,14,44,.318,20,43,.465,5,7,.714,87
Donovan Mitchell,SG,22,UTA,77,2598,661,1530,.432,188,519,.362,473,1011,.468,319,396,.806,1829
Malik Monk,SG,20,CHO,73,1258,227,586,.387,109,330,.330,118,256,.461,90,102,.882,653
Greg Monroe,C,28,TOT,43,480,92,189,.487,1,5,.200,91,184,.495,45,72,.625,230
Jaylen Morris,SG,23,MIL,4,29,4,10,.400,1,3,.333,3,7,.429,1,2,.500,10
Marcus Morris,PF,29,BOS,75,2091,377,844,.447,146,389,.375,231,455,.508,146,173,.844,1046
Markieff Morris,PF,29,TOT,58,1270,204,484,.421,68,203,.335,136,281,.484,71,92,.772,547
Monte Morris,PG,23,DEN,82,1970,346,702,.493,94,227,.414,252,475,.531,65,81,.802,851
Johnathan Motley,PF,23,LAC,22,156,39,73,.534,0,3,.000,39,70,.557,24,40,.600,102
Emmanuel Mudiay,PG,22,NYK,59,1607,330,740,.446,69,210,.329,261,530,.492,144,186,.774,873
Jamal Murray,PG,21,DEN,75,2447,513,1173,.437,152,414,.367,361,759,.476,189,223,.848,1367
Džanan Musa,SG,19,BRK,9,39,9,22,.409,1,10,.100,8,12,.667,0,2,.000,19
Mike Muscala,PF,27,TOT,64,1306,145,361,.402,89,256,.348,56,105,.533,70,85,.824,449
Sviatoslav Mykhailiuk,SF,21,TOT,42,440,46,140,.329,29,89,.326,17,51,.333,12,20,.600,133
Abdel Nader,SF,25,OKC,61,694,91,215,.423,32,100,.320,59,115,.513,27,36,.750,241
Larry Nance Jr.,C,26,CLE,67,1795,249,479,.520,33,98,.337,216,381,.567,96,134,.716,627
Shabazz Napier,PG,27,BRK,56,983,169,435,.389,76,228,.333,93,207,.449,115,138,.833,529
Raul Neto,PG,26,UTA,37,474,74,161,.460,20,60,.333,54,101,.535,28,33,.848,196
Georges Niang,PF,25,UTA,59,516,86,181,.475,43,105,.410,43,76,.566,20,24,.833,235
Joakim Noah,C,33,MEM,42,693,110,213,.516,0,1,.000,110,212,.519,78,109,.716,298
Dirk Nowitzki,PF,40,DAL,51,795,135,376,.359,64,205,.312,71,171,.415,39,50,.780,373
Frank Ntilikina,PG,20,NYK,43,904,95,282,.337,33,115,.287,62,167,.371,23,30,.767,246
James Nunnally,SF,28,TOT,15,102,12,34,.353,8,25,.320,4,9,.444,4,4,1,36
David Nwaba,SG,26,CLE,51,984,126,262,.481,24,75,.320,102,187,.545,58,85,.682,334
Semi Ojeleye,PF,24,BOS,56,594,67,158,.424,28,89,.315,39,69,.565,24,39,.615,186
Jahlil Okafor,C,23,NOP,59,935,212,362,.586,1,5,.200,211,357,.591,59,89,.663,484
Elie Okobo,PG,21,PHO,53,958,114,290,.393,39,132,.295,75,158,.475,37,47,.787,304
Josh Okogie,SG,20,MIN,74,1757,196,508,.386,60,215,.279,136,293,.464,118,162,.728,570
Victor Oladipo,SG,26,IND,36,1147,249,588,.423,74,216,.343,175,372,.470,103,141,.730,675
Kelly Olynyk,PF,27,MIA,79,1812,261,564,.463,113,319,.354,148,245,.604,152,185,.822,787
Cedi Osman,SF,23,CLE,76,2444,360,844,.427,130,374,.348,230,470,.489,141,181,.779,991
Kelly Oubre Jr.,SF,23,TOT,69,1935,375,842,.445,108,338,.320,267,504,.530,189,244,.775,1047
Zaza Pachulia,C,34,DET,68,878,85,193,.440,0,4,.000,85,189,.450,97,124,.782,267
Jabari Parker,PF,23,TOT,64,1724,369,749,.493,61,195,.313,308,554,.556,131,184,.712,930
Tony Parker,PG,36,CHO,56,1003,213,463,.460,13,51,.255,200,412,.485,91,124,.734,530
Chandler Parsons,SF,30,MEM,25,496,68,182,.374,29,94,.309,39,88,.443,22,25,.880,187
Patrick Patterson,PF,29,OKC,63,861,82,219,.374,46,137,.336,36,82,.439,19,30,.633,229
Justin Patton,C,21,PHI,3,21,2,7,.286,0,2,.000,2,5,.400,1,2,.500,5
Chris Paul,PG,33,HOU,58,1857,302,720,.419,127,355,.358,175,365,.479,175,203,.862,906
Cameron Payne,PG,24,TOT,40,712,96,223,.430,25,84,.298,71,139,.511,33,41,.805,250
Elfrid Payton,PG,24,NOP,42,1250,179,412,.434,33,105,.314,146,307,.476,55,74,.743,446
Theo Pinson,SG,23,BRK,18,211,25,73,.342,12,46,.261,13,27,.481,19,22,.864,81
Mason Plumlee,C,28,DEN,82,1731,262,442,.593,2,10,.200,260,432,.602,111,198,.561,637
Quincy Pondexter,SF,30,SAS,53,292,29,58,.500,6,18,.333,23,40,.575,34,42,.810,98
Otto Porter,SF,25,TOT,56,1683,299,643,.465,104,256,.406,195,387,.504,78,96,.813,780
Bobby Portis,PF,23,TOT,50,1299,279,628,.444,75,191,.393,204,437,.467,77,97,.794,710
Dwight Powell,C,27,DAL,77,1662,290,486,.597,39,127,.307,251,359,.699,196,254,.772,815
Norman Powell,SG,25,TOR,60,1126,193,400,.483,68,170,.400,125,230,.543,62,75,.827,516
Alex Poythress,PF,25,ATL,21,305,40,81,.494,9,23,.391,31,58,.534,18,29,.621,107
Ivan Rabb,PF,21,MEM,49,721,116,212,.547,3,15,.200,113,197,.574,49,69,.710,284
Chasson Randle,PG,25,WAS,49,743,91,217,.419,46,115,.400,45,102,.441,43,62,.694,271
Julius Randle,PF,24,NOP,73,2232,571,1089,.524,67,195,.344,504,894,.564,356,487,.731,1565
J.J. Redick,SG,34,PHI,76,2379,452,1027,.440,240,605,.397,212,422,.502,228,255,.894,1372
Cameron Reynolds,SG,23,MIN,19,259,33,78,.423,21,51,.412,12,27,.444,8,9,.889,95
Josh Richardson,SG,25,MIA,73,2539,423,1026,.412,164,460,.357,259,566,.458,199,231,.861,1209
Malachi Richardson,SG,23,TOR,22,103,9,29,.310,8,25,.320,1,4,.250,4,5,.800,30
Austin Rivers,SG,26,TOT,76,2028,232,572,.406,104,327,.318,128,245,.522,50,95,.526,618
Devin Robinson,SF,23,WAS,7,95,19,32,.594,0,2,.000,19,30,.633,9,14,.643,47
Duncan Robinson,PF,24,MIA,15,161,18,46,.391,10,35,.286,8,11,.727,4,6,.667,50
Glenn Robinson III,SF,25,DET,47,610,74,176,.420,18,62,.290,56,114,.491,32,40,.800,198
Jerome Robinson,SG,21,LAC,33,320,44,110,.400,18,57,.316,26,53,.491,6,9,.667,112
Rajon Rondo,PG,32,LAL,46,1369,175,432,.405,51,142,.359,124,290,.428,23,36,.639,424
Derrick Rose,PG,30,MIN,51,1392,363,753,.482,54,146,.370,309,607,.509,137,160,.856,917
Terrence Ross,SG,27,ORL,81,2150,440,1027,.428,217,566,.383,223,461,.484,126,144,.875,1223
Terry Rozier,PG,24,BOS,79,1791,258,666,.387,119,337,.353,139,329,.422,73,93,.785,708
Ricky Rubio,PG,28,UTA,68,1899,295,730,.404,79,254,.311,216,476,.454,195,228,.855,864
Domantas Sabonis,C,22,IND,74,1838,413,700,.590,9,17,.529,404,683,.592,208,291,.715,1043
Brandon Sampson,SG,21,CHI,14,214,28,60,.467,11,29,.379,17,31,.548,4,6,.667,71
JaKarr Sampson,SF,25,CHI,4,127,29,54,.537,5,14,.357,24,40,.600,17,21,.810,80
Mike Scott,PF,30,TOT,79,1395,168,420,.400,101,252,.401,67,168,.399,22,33,.667,459
Thabo Sefolosha,SF,34,UTA,50,609,71,149,.477,34,78,.436,37,71,.521,14,22,.636,190
Wayne Selden,SG,24,TOT,75,1439,196,483,.406,55,174,.316,141,309,.456,67,92,.728,514
Collin Sexton,PG,20,CLE,82,2605,519,1206,.430,119,296,.402,400,910,.440,214,255,.839,1371
Landry Shamet,SG,21,TOT,79,1802,240,557,.431,167,396,.422,73,161,.453,75,93,.806,722
Iman Shumpert,SG,28,TOT,62,1481,167,446,.374,95,273,.348,72,173,.416,36,45,.800,465
Pascal Siakam,PF,24,TOR,80,2548,519,945,.549,79,214,.369,440,731,.602,237,302,.785,1354
Ben Simmons,PG,22,PHI,79,2700,540,960,.563,0,6,.000,540,954,.566,257,428,.600,1337
Jonathon Simmons,SG-SF,29,TOT,56,1064,133,350,.380,28,104,.269,105,246,.427,72,97,.742,366
Anfernee Simons,SG,19,POR,20,141,28,63,.444,10,29,.345,18,34,.529,9,16,.563,75
Marcus Smart,SG,24,BOS,80,2200,239,567,.422,126,346,.364,113,221,.511,104,129,.806,708
Dennis Smith Jr.,PG,21,TOT,53,1508,278,650,.428,67,208,.322,211,442,.477,99,156,.635,722
Ish Smith,PG,30,DET,56,1251,205,489,.419,44,135,.326,161,354,.455,47,62,.758,501
J.R. Smith,SG,33,CLE,11,222,27,79,.342,12,39,.308,15,40,.375,8,10,.800,74
Jason Smith,PF-C,32,TOT,20,190,21,59,.356,9,26,.346,12,33,.364,14,16,.875,65
Zhaire Smith,SG,19,PHI,6,111,14,34,.412,6,16,.375,8,18,.444,6,8,.750,40
Tony Snell,SF,27,MIL,74,1304,163,361,.452,81,204,.397,82,157,.522,37,42,.881,444
Ray Spalding,PF,21,TOT,14,148,25,47,.532,0,3,.000,25,44,.568,4,12,.333,54
Omari Spellman,PF,21,ATL,46,805,98,244,.402,44,128,.344,54,116,.466,32,45,.711,272
Nik Stauskas,SG,25,TOT,68,1015,136,338,.402,70,188,.372,66,150,.440,57,64,.891,399
Lance Stephenson,SG,28,LAL,68,1123,184,432,.426,73,197,.371,111,235,.472,50,73,.685,491
Edmond Sumner,PG,23,IND,23,210,22,64,.344,7,27,.259,15,37,.405,15,24,.625,66
Caleb Swanigan,PF,21,TOT,21,178,18,53,.340,1,7,.143,17,46,.370,6,9,.667,43
Jayson Tatum,SF,20,BOS,79,2455,466,1036,.450,116,311,.373,350,725,.483,195,228,.855,1243
Jeff Teague,PG,30,MIN,42,1264,176,416,.423,35,105,.333,141,311,.453,123,153,.804,510
Garrett Temple,SG,32,TOT,75,2040,208,493,.422,90,264,.341,118,229,.515,80,107,.748,586
Jared Terrell,SG,23,MIN,14,111,12,39,.308,4,17,.235,8,22,.364,3,6,.500,31
Daniel Theis,C,26,BOS,66,908,146,266,.549,26,67,.388,120,199,.603,56,76,.737,374
Isaiah Thomas,SG,29,DEN,12,181,34,99,.343,12,43,.279,22,56,.393,17,27,.630,97
Khyri Thomas,SG,22,DET,26,195,22,69,.319,10,35,.286,12,34,.353,7,11,.636,61
Lance Thomas,PF,30,NYK,46,783,78,197,.396,22,79,.278,56,118,.475,27,36,.750,205
Klay Thompson,SG,28,GSW,78,2652,655,1402,.467,241,599,.402,414,803,.516,129,158,.816,1680
Sindarius Thornwell,SG,24,LAC,64,313,17,49,.347,3,15,.200,14,34,.412,25,34,.735,62
Anthony Tolliver,PF,33,MIN,65,1079,99,259,.382,81,215,.377,18,44,.409,47,60,.783,326
Karl-Anthony Towns,C,23,MIN,77,2545,681,1314,.518,142,355,.400,539,959,.562,376,450,.836,1880
Gary Trent Jr.,SG,20,POR,15,111,16,50,.320,5,21,.238,11,29,.379,3,7,.429,40
Allonzo Trier,SG,23,NYK,64,1459,232,518,.448,52,132,.394,180,386,.466,179,223,.803,695
P.J. Tucker,PF,33,HOU,82,2802,207,523,.396,146,387,.377,61,136,.449,41,59,.695,601
Evan Turner,PG,30,POR,73,1605,204,443,.460,11,52,.212,193,391,.494,75,106,.708,494
Myles Turner,C,22,IND,74,2119,380,780,.487,76,196,.388,304,584,.521,148,201,.736,984
Jarred Vanderbilt,PF,19,DEN,17,69,9,19,.474,0,1,.000,9,18,.500,6,10,.600,24
Fred VanVleet,PG,24,TOR,64,1760,246,600,.410,112,296,.378,134,304,.441,97,115,.843,701
Noah Vonleh,PF,23,NYK,68,1722,207,440,.470,46,137,.336,161,303,.531,111,156,.712,571
Dwyane Wade,SG,37,MIA,72,1885,416,960,.433,86,261,.330,330,699,.472,165,233,.708,1083
Moritz Wagner,C,21,LAL,43,446,71,171,.415,22,77,.286,49,94,.521,43,53,.811,207
Dion Waiters,SG,27,MIA,44,1138,198,478,.414,109,289,.377,89,189,.471,22,44,.500,527
Kemba Walker,PG,28,CHO,82,2863,731,1684,.434,260,731,.356,471,953,.494,380,450,.844,2102
Lonnie Walker,SG,20,SAS,17,118,16,46,.348,5,13,.385,11,33,.333,8,10,.800,45
John Wall,PG,28,WAS,32,1104,245,552,.444,51,169,.302,194,383,.507,122,175,.697,663
Tyrone Wallace,PG,24,LAC,62,628,92,217,.424,4,19,.211,88,198,.444,30,57,.526,218
Taurean Prince,SF,24,ATL,55,1552,262,594,.441,123,315,.390,139,279,.498,95,116,.819,742
Brad Wanamaker,PG,29,BOS,36,343,50,105,.476,16,39,.410,34,66,.515,24,28,.857,140
T.J. Warren,SF,25,PHO,43,1360,297,611,.486,77,180,.428,220,431,.510,101,124,.815,772
Julian Washburn,SF,27,MEM,18,254,16,48,.333,5,24,.208,11,24,.458,3,4,.750,40
Yuta Watanabe,SF,24,MEM,15,174,15,51,.294,2,16,.125,13,35,.371,7,10,.700,39
Thomas Welsh,C,22,DEN,11,36,7,13,.538,3,7,.429,4,6,.667,1,2,.500,18
Russell Westbrook,PG,30,OKC,73,2630,630,1473,.428,119,411,.290,511,1062,.481,296,451,.656,1675
Derrick White,PG,24,SAS,67,1728,260,543,.479,48,142,.338,212,401,.529,95,123,.772,663
Hassan Whiteside,C,29,MIA,72,1674,388,680,.571,2,16,.125,386,664,.581,109,243,.449,887
Andrew Wiggins,SF,23,MIN,73,2543,498,1209,.412,118,348,.339,380,861,.441,207,296,.699,1321
Alan Williams,PF,26,BRK,5,26,8,13,.615,0,1,.000,8,12,.667,2,4,.500,18
C.J. Williams,SG,28,MIN,15,128,17,35,.486,5,16,.313,12,19,.632,0,1,.000,39
Johnathan Williams,C,23,LAL,24,372,65,110,.591,0,2,.000,65,108,.602,27,48,.563,157
Kenrich Williams,SF,24,NOP,46,1079,107,279,.384,52,156,.333,55,123,.447,13,19,.684,279
Lou Williams,SG,32,LAC,75,1993,484,1138,.425,105,291,.361,379,847,.447,425,485,.876,1498
Marvin Williams,PF,32,CHO,75,2133,275,652,.422,140,382,.366,135,270,.500,66,86,.767,756
Troy Williams,SF,24,SAC,21,312,44,98,.449,14,44,.318,30,54,.556,9,15,.600,111
D.J. Wilson,PF,22,MIL,48,882,104,251,.414,46,127,.362,58,124,.468,26,47,.553,280
Justise Winslow,SF,22,MIA,66,1959,324,749,.433,96,256,.375,228,493,.462,86,137,.628,830
Christian Wood,PF,23,TOT,21,251,61,117,.521,9,26,.346,52,91,.571,41,56,.732,172
Delon Wright,PG,26,TOT,75,1699,242,558,.434,50,168,.298,192,390,.492,119,150,.793,653
Guerschon Yabusele,PF,23,BOS,41,251,35,77,.455,9,28,.321,26,49,.531,15,22,.682,94
Thaddeus Young,PF,30,IND,81,2489,443,841,.527,51,146,.349,392,695,.564,87,135,.644,1024
Trae Young,PG,20,ATL,81,2503,525,1256,.418,156,482,.324,369,774,.477,343,414,.829,1549
Cody Zeller,C,26,CHO,49,1243,190,345,.551,6,22,.273,184,323,.570,111,141,.787,497
Tyler Zeller,C,29,TOT,6,93,16,30,.533,0,1,.000,16,29,.552,14,18,.778,46
